COUNTRY,DATE,MALE_HOSPITALIZED,MALE_DEAD,FEMALE_HOSPITALIZED,FEMALE_DEAD,TOTAL_HOSPITALIZED,TOTAL_DEAD,MH_7Day_Mean,MD_7Day_Mean,FH_7Day_Mean,FD_7Day_Mean,TH_7Day_Mean,TD_7Day_Mean
Aleppo,2009-04-16,12394,0,12448,0,24842,0,12394,0,12448,0,24842,0
Aleppo,2009-04-17,12272,0,12307,0,24579,0,12333,0,12377,0,24710,0
Aleppo,2009-04-18,10574,0,10425,0,20999,0,11746,0,11726,0,23473,0
Aleppo,2009-04-19,11168,1,11239,4,22407,5,11602,0,11604,1,23206,1
Aleppo,2009-04-20,16168,9,16154,7,32322,16,12515,2,12514,2,25029,4
Aleppo,2009-04-21,15090,7,15029,5,30119,12,12944,2,12933,2,25878,5
Aleppo,2009-04-22,11066,12,11069,9,22135,21,12676,4,12667,3,25343,7
Aleppo,2009-04-23,11293,10,11122,8,22415,18,12518,5,12477,4,24996,10
Aleppo,2009-04-24,9052,15,9004,14,18056,29,12058,7,12006,6,24064,14
Aleppo,2009-04-25,13303,19,13371,22,26674,41,12448,10,12426,9,24875,20
Aleppo,2009-04-26,8236,16,8226,12,16462,28,12029,12,11996,11,24026,23
Aleppo,2009-04-27,13753,12,13654,10,27407,22,11684,13,11639,11,23324,24
Aleppo,2009-04-28,15177,15,15204,10,30381,25,11697,14,11664,12,23361,26
Aleppo,2009-04-29,18174,14,18209,8,36383,22,12712,14,12684,12,25396,26
Aleppo,2009-04-30,9136,11,9126,11,18262,22,12404,14,12399,12,24803,27
Aleppo,2009-05-01,9677,17,9722,19,19399,36,12493,14,12501,13,24995,28
Aleppo,2009-05-02,20855,20,20597,25,41452,45,13572,15,13534,13,27106,28
Aleppo,2009-05-03,11230,57,11384,55,22614,112,14000,20,13985,19,27985,40
Aleppo,2009-05-04,13284,76,13416,61,26700,137,13933,30,13951,27,27884,57
Aleppo,2009-05-05,21380,252,21507,218,42887,470,14819,63,14851,56,29671,120
Aleppo,2009-05-06,21405,296,21480,281,42885,577,15281,104,15318,95,30599,199
Aleppo,2009-05-07,25671,345,25770,337,51441,682,17643,151,17696,142,35339,294
Aleppo,2009-05-08,12750,373,12638,429,25388,802,18082,202,18113,200,36195,403
Aleppo,2009-05-09,19015,472,18963,462,37978,934,17819,267,17879,263,35699,530
Aleppo,2009-05-10,25347,540,25462,558,50809,1098,19836,336,19890,335,39726,671
Aleppo,2009-05-11,17652,633,17440,633,35092,1266,20460,415,20465,416,40925,832
Aleppo,2009-05-12,24994,740,25056,716,50050,1456,20976,485,20972,488,41949,973
Aleppo,2009-05-13,35557,800,35356,840,70913,1640,22998,557,22955,567,45953,1125
Aleppo,2009-05-14,27414,931,27530,953,54944,1884,23247,641,23206,655,46453,1297
Aleppo,2009-05-15,23668,1095,23693,1055,47361,2150,24806,744,24785,745,49592,1489
Aleppo,2009-05-16,24704,1254,24859,1186,49563,2440,25619,856,25628,848,51247,1704
Aleppo,2009-05-17,26706,1331,26772,1389,53478,2720,25813,969,25815,967,51628,1936
Aleppo,2009-05-18,31283,1478,31276,1562,62559,3040,27760,1089,27791,1100,55552,2190
Aleppo,2009-05-19,25139,1716,24803,1632,49942,3348,27781,1229,27755,1231,55537,2460
Aleppo,2009-05-20,26421,1862,26154,1763,52575,3625,26476,1381,26441,1362,52917,2743
Aleppo,2009-05-21,28864,1886,28863,1954,57727,3840,26683,1517,26631,1505,53315,3023
Aleppo,2009-05-22,20082,1992,20258,2006,40340,3998,26171,1645,26140,1641,52312,3287
Aleppo,2009-05-23,21409,2059,21256,2010,42665,4069,25700,1760,25626,1759,51326,3520
Aleppo,2009-05-24,17764,2050,17693,1992,35457,4042,24423,1863,24329,1845,48752,3708
Aleppo,2009-05-25,20222,1976,20339,1949,40561,3925,22843,1934,22766,1900,45609,3835
Aleppo,2009-05-26,12356,1830,12225,1908,24581,3738,21016,1950,20969,1940,41986,3891
Aleppo,2009-05-27,12264,1806,12379,1687,24643,3493,18994,1942,19001,1929,37996,3872
Aleppo,2009-05-28,16816,1567,16668,1624,33484,3191,17273,1897,17259,1882,34533,3779
Aleppo,2009-05-29,12269,1421,12374,1449,24643,2870,16157,1815,16133,1802,32290,3618
Aleppo,2009-05-30,6474,1307,6330,1237,12804,2544,14023,1708,14001,1692,28024,3400
Aleppo,2009-05-31,10319,1153,10610,1075,20929,2228,12960,1580,12989,1561,25949,3141
Aleppo,2009-06-01,13913,955,14008,964,27921,1919,12058,1434,12084,1420,24143,2854
Aleppo,2009-06-02,12422,802,12434,836,24856,1638,12068,1287,12114,1267,24182,2554
Aleppo,2009-06-03,1134,704,1147,693,2281,1397,10478,1129,10510,1125,20988,2255
Aleppo,2009-06-04,12470,576,12796,593,25266,1169,9857,988,9957,978,19814,1966
Aleppo,2009-06-05,16949,519,17058,473,34007,992,10525,859,10626,838,21152,1698
Aleppo,2009-06-06,15471,422,15708,388,31179,810,11811,733,11965,717,23777,1450
Aleppo,2009-06-07,13907,362,13933,321,27840,683,12323,620,12440,609,24764,1229
Aleppo,2009-06-08,6147,274,5915,284,12062,558,11214,522,11284,512,22498,1035
Aleppo,2009-06-09,6093,222,6221,244,12314,466,10310,439,10396,428,20707,867
Aleppo,2009-06-10,13785,210,13768,193,27553,403,12117,369,12199,356,24317,725
Aleppo,2009-06-11,12485,179,12466,155,24951,334,12119,312,12152,294,24272,606
Aleppo,2009-06-12,11992,133,11953,134,23945,267,11411,257,11423,245,22834,503
Aleppo,2009-06-13,4990,111,5006,105,9996,216,9914,213,9894,205,19808,418
Aleppo,2009-06-14,7371,87,7193,92,14564,179,8980,173,8931,172,17912,346
Aleppo,2009-06-15,8725,79,9033,72,17758,151,9348,145,9377,142,18725,288
Aleppo,2009-06-16,12429,68,12400,67,24829,135,10253,123,10259,116,20513,240
Aleppo,2009-06-17,14474,57,14527,60,29001,117,10352,102,10368,97,20720,199
Aleppo,2009-06-18,9614,53,9561,42,19175,95,9942,84,9953,81,19895,165
Aleppo,2009-06-19,13199,38,13017,31,26216,69,10114,70,10105,67,20219,137
Aleppo,2009-06-20,9812,27,9787,35,19599,62,10803,58,10788,57,21591,115
Aleppo,2009-06-21,13311,39,13165,32,26476,71,11652,51,11641,48,23293,100
Aleppo,2009-06-22,11176,20,11084,24,22260,44,12002,43,11934,41,23936,84
Aleppo,2009-06-23,7851,31,8186,22,16037,53,11348,37,11332,35,22680,73
Aleppo,2009-06-24,9436,23,9374,23,18810,46,10628,33,10596,29,21224,62
Aleppo,2009-06-25,7377,26,7274,21,14651,47,10308,29,10269,26,20578,56
Aleppo,2009-06-26,3866,10,3584,9,7450,19,8975,25,8922,23,17897,48
Aleppo,2009-06-27,16763,9,16810,13,33573,22,9968,22,9925,20,19893,43
Aleppo,2009-06-28,16101,9,15988,7,32089,16,10367,18,10328,17,20695,35
Aleppo,2009-06-29,8391,8,8291,11,16682,19,9969,16,9929,15,19898,31
Aleppo,2009-06-30,0,11,0,3,0,14,8847,13,8760,12,17607,26
Colombia,2009-04-16,3850,0,3763,0,7613,0,3850,0,3763,0,7613,0
Colombia,2009-04-17,2075,0,2087,0,4162,0,2962,0,2925,0,5887,0
Colombia,2009-04-18,3424,0,3180,0,6604,0,3116,0,3010,0,6126,0
Colombia,2009-04-19,2654,0,2754,0,5408,0,3000,0,2946,0,5946,0
Colombia,2009-04-20,2588,1,2632,3,5220,4,2918,0,2883,0,5801,0
Colombia,2009-04-21,3090,2,3202,1,6292,3,2946,0,2936,0,5883,1
Colombia,2009-04-22,4108,1,4093,1,8201,2,3112,0,3101,0,6214,1
Colombia,2009-04-23,5134,1,5120,4,10254,5,3296,0,3295,1,6591,2
Colombia,2009-04-24,5041,0,4947,6,9988,6,3719,0,3704,2,7423,2
Colombia,2009-04-25,4453,2,4423,4,8876,6,3866,1,3881,2,7748,3
Colombia,2009-04-26,3989,2,4166,5,8155,7,4057,1,4083,3,8140,4
Colombia,2009-04-27,3865,6,3912,7,7777,13,4240,2,4266,4,8506,6
Colombia,2009-04-28,3858,6,3802,6,7660,12,4349,2,4351,4,8701,7
Colombia,2009-04-29,3055,4,3289,5,6344,9,4199,3,4237,5,8436,8
Colombia,2009-04-30,3505,6,3456,3,6961,9,3966,3,3999,5,7965,8
Colombia,2009-05-01,4742,3,4851,5,9593,8,3923,4,3985,5,7909,9
Colombia,2009-05-02,5749,6,5527,1,11276,7,4109,4,4143,4,8252,9
Colombia,2009-05-03,5340,2,5590,4,10930,6,4302,4,4346,4,8648,9
Colombia,2009-05-04,3602,4,3580,4,7182,8,4264,4,4299,4,8563,8
Colombia,2009-05-05,6962,11,6966,8,13928,19,4707,5,4751,4,9459,9
Colombia,2009-05-06,3651,16,3776,13,7427,29,4793,6,4820,5,9613,12
Colombia,2009-05-07,3655,25,3722,20,7377,45,4814,9,4858,7,9673,17
Colombia,2009-05-08,5626,27,5547,27,11173,54,4940,13,4958,11,9899,24
Colombia,2009-05-09,4905,81,4772,64,9677,145,4820,23,4850,20,9670,43
Colombia,2009-05-10,5201,93,5238,84,10439,177,4800,36,4800,31,9600,68
Colombia,2009-05-11,7432,99,7509,102,14941,201,5347,50,5361,45,10708,95
Colombia,2009-05-12,5515,116,5563,112,11078,228,5140,65,5161,60,10301,125
Colombia,2009-05-13,5794,123,5745,113,11539,236,5446,80,5442,74,10889,155
Colombia,2009-05-14,5815,122,5759,148,11574,270,5755,94,5733,92,11488,187
Colombia,2009-05-15,4870,153,4956,149,9826,302,5647,112,5648,110,11296,222
Colombia,2009-05-16,7678,160,7547,168,15225,328,6043,123,6045,125,12088,248
Colombia,2009-05-17,3783,168,3803,188,7586,356,5841,134,5840,140,11681,274
Colombia,2009-05-18,5325,179,5399,202,10724,381,5540,145,5538,154,11078,300
Colombia,2009-05-19,5936,216,5847,214,11783,430,5600,160,5579,168,11179,329
Colombia,2009-05-20,7296,259,7414,229,14710,488,5814,179,5817,185,11632,365
Colombia,2009-05-21,6606,287,6615,259,13221,546,5927,203,5940,201,11867,404
Colombia,2009-05-22,6833,307,6863,293,13696,600,6208,225,6212,221,12420,447
Colombia,2009-05-23,9297,328,9253,317,18550,645,6439,249,6456,243,12895,492
Colombia,2009-05-24,5337,355,5480,331,10817,686,6661,275,6695,263,13357,539
Colombia,2009-05-25,6321,373,6356,360,12677,733,6803,303,6832,286,13636,589
Colombia,2009-05-26,5632,362,5479,411,11111,773,6760,324,6780,314,13540,638
Colombia,2009-05-27,4318,380,4480,407,8798,787,6334,341,6360,339,12695,681
Colombia,2009-05-28,7708,383,7647,410,15355,793,6492,355,6508,361,13000,716
Colombia,2009-05-29,4730,406,4736,366,9466,772,6191,369,6204,371,12396,741
Colombia,2009-05-30,4057,357,3912,381,7969,738,5443,373,5441,380,10884,754
Colombia,2009-05-31,4917,363,5025,330,9942,693,5383,374,5376,380,10759,755
Colombia,2009-06-01,2756,319,2841,323,5597,642,4874,367,4874,375,9748,742
Colombia,2009-06-02,5036,273,4890,309,9926,582,4788,354,4790,360,9579,715
Colombia,2009-06-03,3137,280,3182,235,6319,515,4620,340,4604,336,9224,676
Colombia,2009-06-04,4411,208,4398,246,8809,454,4149,315,4140,312,8289,628
Colombia,2009-06-05,6276,215,6342,182,12618,397,4370,287,4370,286,8740,574
Colombia,2009-06-06,4323,174,4207,168,8530,342,4408,261,4412,256,8820,517
Colombia,2009-06-07,3526,150,3728,146,7254,296,4209,231,4226,229,8436,461
Colombia,2009-06-08,5525,130,5506,121,11031,251,4604,204,4607,201,9212,405
Colombia,2009-06-09,3820,101,3847,108,7667,209,4431,179,4458,172,8889,352
Colombia,2009-06-10,6337,79,6310,92,12647,171,4888,151,4905,151,9793,302
Colombia,2009-06-11,1319,76,1327,73,2646,149,4446,132,4466,127,8913,259
Colombia,2009-06-12,4448,58,4258,59,8706,117,4185,109,4169,109,8354,219
Colombia,2009-06-13,5312,49,5454,52,10766,101,4326,91,4347,93,8673,184
Colombia,2009-06-14,5239,36,5177,47,10416,83,4571,75,4554,78,9125,154
Colombia,2009-06-15,4435,32,4189,38,8624,70,4415,61,4366,67,8781,128
Colombia,2009-06-16,2897,29,2838,29,5735,58,4283,51,4221,55,8505,107
Colombia,2009-06-17,5057,29,5088,22,10145,51,4101,44,4047,45,8148,89
Colombia,2009-06-18,1816,25,1857,19,3673,44,4172,36,4123,38,8295,74
Colombia,2009-06-19,4260,23,4213,16,8473,39,4145,31,4116,31,8261,63
Colombia,2009-06-20,5010,17,5080,13,10090,30,4102,27,4063,26,8165,53
Colombia,2009-06-21,6337,14,6253,14,12590,28,4258,24,4216,21,8475,45
Colombia,2009-06-22,5070,8,5051,14,10121,22,4349,20,4340,18,8689,38
Colombia,2009-06-23,4811,13,4769,9,9580,22,4623,18,4615,15,9238,33
Colombia,2009-06-24,4947,5,5012,10,9959,15,4607,15,4605,13,9212,28
Colombia,2009-06-25,4188,5,4115,11,8303,16,4946,12,4927,12,9873,24
Colombia,2009-06-26,4838,10,4940,11,9778,21,5028,10,5031,11,10060,22
Colombia,2009-06-27,4,5,3,7,7,12,4313,8,4306,10,8619,19
Colombia,2009-06-28,3651,4,3507,10,7158,14,3929,7,3913,10,7843,17
Colombia,2009-06-29,4459,6,4549,7,9008,13,3842,6,3842,9,7684,16
Colombia,2009-06-30,0,7,0,7,0,14,3155,6,3160,9,6316,15
Iran,2009-04-16,547,0,552,0,1099,0,547,0,552,0,1099,0
Iran,2009-04-17,4660,0,4584,0,9244,0,2603,0,2568,0,5171,0
Iran,2009-04-18,2749,0,2774,0,5523,0,2652,0,2636,0,5288,0
Iran,2009-04-19,7118,0,6862,0,13980,0,3768,0,3693,0,7461,0
Iran,2009-04-20,3641,0,3636,0,7277,0,3743,0,3681,0,7424,0
Iran,2009-04-21,2934,3,2878,1,5812,4,3608,0,3547,0,7155,0
Iran,2009-04-22,3207,3,3240,1,6447,4,3550,0,3503,0,7054,1
Iran,2009-04-23,970,6,991,2,1961,8,3611,1,3566,0,7177,2
Iran,2009-04-24,3771,4,3736,6,7507,10,3484,2,3445,1,6929,3
Iran,2009-04-25,3154,1,3101,5,6255,6,3542,2,3492,2,7034,4
Iran,2009-04-26,3943,3,3802,2,7745,5,3088,2,3054,2,6143,5
Iran,2009-04-27,2659,2,2647,1,5306,3,2948,3,2913,2,5861,5
Iran,2009-04-28,707,2,751,1,1458,3,2630,3,2609,2,5239,5
Iran,2009-04-29,3439,3,3549,6,6988,9,2663,3,2653,3,5317,6
Iran,2009-04-30,2188,4,2240,3,4428,7,2837,2,2832,3,5669,6
Iran,2009-05-01,3554,3,3629,5,7183,8,2806,2,2817,3,5623,5
Iran,2009-05-02,3229,3,3285,6,6514,9,2817,2,2843,3,5660,6
Iran,2009-05-03,5304,4,5416,6,10720,10,3011,3,3073,4,6085,7
Iran,2009-05-04,7666,9,7759,3,15425,12,3726,4,3804,4,7530,8
Iran,2009-05-05,2637,12,2564,5,5201,17,4002,5,4063,4,8065,10
Iran,2009-05-06,3091,24,3087,26,6178,50,3952,8,3997,7,7949,16
Iran,2009-05-07,1862,34,1880,33,3742,67,3906,12,3945,12,7851,24
Iran,2009-05-08,4885,75,4781,72,9666,147,4096,23,4110,21,8206,44
Iran,2009-05-09,4168,95,4075,87,8243,182,4230,36,4223,33,8453,69
Iran,2009-05-10,4875,88,4800,113,9675,201,4169,48,4135,48,8304,96
Iran,2009-05-11,4853,116,4881,112,9734,228,3767,63,3724,64,7491,127
Iran,2009-05-12,2722,120,2752,118,5474,238,3779,78,3750,80,7530,159
Iran,2009-05-13,4296,111,4288,137,8584,248,3951,91,3922,96,7874,187
Iran,2009-05-14,2230,126,2209,111,4439,237,4004,104,3969,107,7973,211
Iran,2009-05-15,3050,118,3106,124,6156,242,3742,110,3730,114,7472,225
Iran,2009-05-16,5150,133,5033,137,10183,270,3882,116,3867,121,7749,237
Iran,2009-05-17,3504,147,3599,149,7103,296,3686,124,3695,126,7381,251
Iran,2009-05-18,5543,163,5430,154,10973,317,3785,131,3773,132,7558,264
Iran,2009-05-19,5470,164,5313,168,10783,332,4177,137,4139,140,8317,277
Iran,2009-05-20,5432,163,5334,182,10766,345,4339,144,4289,146,8629,291
Iran,2009-05-21,7108,197,7100,194,14208,391,5036,155,4987,158,10024,313
Iran,2009-05-22,5577,226,5668,212,11245,438,5397,170,5353,170,10751,341
Iran,2009-05-23,4963,239,4855,235,9818,474,5371,185,5328,184,10699,370
Iran,2009-05-24,5689,255,5739,257,11428,512,5683,201,5634,200,11317,401
Iran,2009-05-25,4973,292,5086,242,10059,534,5601,219,5585,212,11186,432
Iran,2009-05-26,4399,259,4517,290,8916,549,5448,233,5471,230,10920,463
Iran,2009-05-27,5821,281,5820,269,11641,550,5504,249,5540,242,11045,492
Iran,2009-05-28,3079,277,3175,261,6254,538,4928,261,4980,252,9908,513
Iran,2009-05-29,5487,252,5332,273,10819,525,4915,265,4932,261,9847,526
Iran,2009-05-30,4642,254,4453,235,9095,489,4870,267,4874,261,9744,528
Iran,2009-05-31,3012,213,3064,241,6076,454,4487,261,4492,258,8980,519
Iran,2009-06-01,4003,194,3912,220,7915,414,4349,247,4324,255,8673,502
Iran,2009-06-02,3519,187,3414,184,6933,371,4223,236,4167,240,8390,477
Iran,2009-06-03,4983,174,5011,154,9994,328,4103,221,4051,224,8155,445
Iran,2009-06-04,4127,147,4210,137,8337,284,4253,203,4199,206,8452,409
Iran,2009-06-05,5023,124,5006,122,10029,246,4187,184,4152,184,8339,369
Iran,2009-06-06,1154,106,1138,99,2292,205,3688,163,3679,165,7368,328
Iran,2009-06-07,2340,89,2302,92,4642,181,3592,145,3570,144,7163,289
Iran,2009-06-08,5482,68,5524,79,11006,147,3804,127,3800,123,7604,251
Iran,2009-06-09,2879,54,2979,70,5858,124,3712,108,3738,107,7451,216
Iran,2009-06-10,2656,50,2686,53,5342,103,3380,91,3406,93,6786,184
Iran,2009-06-11,2286,41,2236,42,4522,83,3117,76,3124,79,6241,155
Iran,2009-06-12,2773,25,2838,47,5611,72,2795,61,2814,68,5610,130
Iran,2009-06-13,2625,24,2770,38,5395,62,3005,50,3047,60,6053,110
Iran,2009-06-14,3039,30,3100,27,6139,57,3105,41,3161,50,6267,92
Iran,2009-06-15,24,20,30,25,54,45,2326,34,2377,43,4703,78
Iran,2009-06-16,1886,15,1893,20,3779,35,2184,29,2221,36,4406,65
Iran,2009-06-17,2993,13,3063,16,6056,29,2232,24,2275,30,4508,54
Iran,2009-06-18,4641,11,4500,15,9141,26,2568,19,2599,26,5167,46
Iran,2009-06-19,2094,8,2007,10,4101,18,2471,17,2480,21,4952,38
Iran,2009-06-20,879,8,881,7,1760,15,2222,15,2210,17,4432,32
Iran,2009-06-21,2074,7,2094,8,4168,15,2084,11,2066,14,4151,26
Iran,2009-06-22,3683,8,3491,9,7174,17,2607,10,2561,12,5168,22
Iran,2009-06-23,5913,5,5935,8,11848,13,3182,8,3138,10,6321,19
Iran,2009-06-24,2554,7,2589,6,5143,13,3119,7,3071,9,6190,16
Iran,2009-06-25,3353,4,3352,4,6705,8,2935,6,2907,7,5842,14
Iran,2009-06-26,1567,6,1519,5,3086,11,2860,6,2837,6,5697,13
Iran,2009-06-27,2785,4,2808,6,5593,10,3132,5,3112,6,6245,12
Iran,2009-06-28,3387,7,3377,1,6764,8,3320,5,3295,5,6616,11
Iran,2009-06-29,3182,5,3348,4,6530,9,3248,5,3275,4,6524,10
Iran,2009-06-30,0,7,0,1,0,8,2404,5,2427,3,4831,9
Karachi,2009-04-16,48162,0,48189,0,96351,0,48162,0,48189,0,96351,0
Karachi,2009-04-17,61568,0,61852,0,123420,0,54865,0,55020,0,109885,0
Karachi,2009-04-18,34318,1,34644,0,68962,1,48016,0,48228,0,96244,0
Karachi,2009-04-19,36694,7,36810,16,73504,23,45185,2,45373,4,90559,6
Karachi,2009-04-20,38067,20,37604,19,75671,39,43761,5,43819,7,87581,12
Karachi,2009-04-21,19229,35,19086,47,38315,82,39673,10,39697,13,79370,24
Karachi,2009-04-22,45073,41,44866,45,89939,86,40444,14,40435,18,80880,33
Karachi,2009-04-23,49876,42,50080,42,99956,84,40689,20,40706,24,81395,45
Karachi,2009-04-24,30347,42,30312,30,60659,72,36229,26,36200,28,72429,55
Karachi,2009-04-25,29346,25,29140,37,58486,62,35518,30,35414,33,70932,64
Karachi,2009-04-26,41165,35,41100,31,82265,66,36157,34,36026,35,72184,70
Karachi,2009-04-27,40176,36,39603,41,79779,77,36458,36,36312,39,72771,75
Karachi,2009-04-28,40328,42,40434,27,80762,69,39473,37,39362,36,78835,73
Karachi,2009-04-29,20859,29,18722,39,39581,68,36013,35,35627,35,71641,71
Karachi,2009-04-30,62991,56,62131,35,125122,91,37887,37,37348,34,75236,72
Karachi,2009-05-01,36563,44,36514,38,73077,82,38775,38,38234,35,77010,73
Karachi,2009-05-02,41147,61,41495,66,82642,127,40461,43,39999,39,80461,82
Karachi,2009-05-03,43124,80,43190,59,86314,139,40741,49,40298,43,81039,93
Karachi,2009-05-04,73635,140,73310,138,146945,278,45521,64,45113,57,90634,122
Karachi,2009-05-05,55366,219,55251,188,110617,407,47669,89,47230,80,94899,170
Karachi,2009-05-06,39252,602,39756,612,79008,1214,50296,171,50235,162,100532,334
Karachi,2009-05-07,53862,719,53288,733,107150,1452,48992,266,48972,262,97964,528
Karachi,2009-05-08,67174,874,66782,850,133956,1724,53365,385,53296,378,106661,763
Karachi,2009-05-09,64265,1059,64686,1000,128951,2059,56668,527,56609,511,113277,1039
Karachi,2009-05-10,73019,1166,72863,1202,145882,2368,60939,682,60848,674,121787,1357
Karachi,2009-05-11,92350,1336,92201,1347,184551,2683,63612,853,63546,847,127159,1701
Karachi,2009-05-12,53275,1417,53686,1535,106961,2952,63313,1024,63323,1039,126637,2064
Karachi,2009-05-13,60009,1670,60122,1677,120131,3347,66279,1177,66232,1192,132511,2369
Karachi,2009-05-14,95730,1851,95823,1886,191553,3737,72260,1339,72309,1356,144569,2695
Karachi,2009-05-15,81108,2072,80820,2069,161928,4141,74250,1510,74314,1530,148565,3041
Karachi,2009-05-16,48993,2270,48705,2389,97698,4659,72069,1683,72031,1729,144100,3412
Karachi,2009-05-17,91998,2662,91905,2529,183903,5191,74780,1896,74751,1918,149532,3815
Karachi,2009-05-18,36861,2827,37001,2905,73862,5732,66853,2109,66866,2141,133719,4251
Karachi,2009-05-19,29195,3099,28906,3125,58101,6224,63413,2350,63326,2368,126739,4718
Karachi,2009-05-20,88240,3266,88855,3401,177095,6667,67446,2578,67430,2614,134877,5193
Karachi,2009-05-21,50387,3518,50463,3456,100850,6974,60968,2816,60950,2839,121919,5655
Karachi,2009-05-22,76281,3740,76277,3695,152558,7435,60279,3054,60301,3071,120581,6126
Karachi,2009-05-23,35434,3888,35035,3882,70469,7770,58342,3285,58348,3284,116691,6570
Karachi,2009-05-24,66256,4029,66689,3934,132945,7963,54664,3481,54746,3485,109411,6966
Karachi,2009-05-25,59828,4021,59124,3975,118952,7996,57945,3651,57907,3638,115852,7289
Karachi,2009-05-26,27455,3932,27749,3934,55204,7866,57697,3770,57741,3753,115439,7524
Karachi,2009-05-27,80178,3757,80118,3783,160296,7540,56545,3840,56493,3808,113039,7649
Karachi,2009-05-28,35127,3546,35314,3550,70441,7096,54365,3844,54329,3821,108695,7666
Karachi,2009-05-29,38245,3233,38363,3333,76608,6566,48931,3772,48913,3770,97845,7542
Karachi,2009-05-30,52241,2922,52290,3015,104531,5937,51332,3634,51378,3646,102711,7280
Karachi,2009-05-31,43151,2643,43247,2663,86398,5306,48032,3436,48029,3464,96061,6901
Karachi,2009-06-01,51883,2282,51345,2382,103228,4664,46897,3187,46918,3237,93815,6425
Karachi,2009-06-02,55734,2083,55627,1958,111361,4041,50937,2923,50900,2954,101837,5878
Karachi,2009-06-03,31268,1688,30867,1788,62135,3476,43949,2628,43864,2669,87814,5298
Karachi,2009-06-04,60398,1455,60480,1527,120878,2982,47560,2329,47459,2380,95019,4710
Karachi,2009-06-05,79645,1262,79352,1275,158997,2537,53474,2047,53315,2086,106789,4134
Karachi,2009-06-06,42754,1092,42801,1045,85555,2137,52119,1786,51959,1805,104078,3591
Karachi,2009-06-07,44769,900,45094,899,89863,1799,52350,1537,52223,1553,104573,3090
Karachi,2009-06-08,41359,748,41530,759,82889,1507,50846,1318,50821,1321,101668,2639
Karachi,2009-06-09,63667,658,63789,621,127456,1279,51980,1114,51987,1130,103967,2245
Karachi,2009-06-10,23613,539,23273,521,46886,1060,50886,950,50902,949,101789,1900
Karachi,2009-06-11,51958,452,52464,445,104422,897,49680,807,49757,795,99438,1602
Karachi,2009-06-12,29230,363,28931,381,58161,744,42478,678,42554,667,85033,1346
Karachi,2009-06-13,33815,327,33842,325,67657,652,41201,569,41274,564,82476,1134
Karachi,2009-06-14,303,242,322,274,625,516,34849,475,34878,475,69728,950
Karachi,2009-06-15,38230,211,38482,217,76712,428,34402,398,34443,397,68845,796
Karachi,2009-06-16,53430,187,53328,186,106758,373,32939,331,32948,335,65888,667
Karachi,2009-06-17,30373,135,30780,166,61153,301,33905,273,34021,284,67926,558
Karachi,2009-06-18,50373,118,50658,128,101031,246,33679,226,33763,239,67442,465
Karachi,2009-06-19,11654,101,11554,103,23208,204,31168,188,31280,199,62449,388
Karachi,2009-06-20,16321,87,16349,104,32670,191,28669,154,28781,168,57451,322
Karachi,2009-06-21,59866,96,60046,67,119912,163,37178,133,37313,138,74492,272
Karachi,2009-06-22,29991,79,30133,82,60124,161,36001,114,36121,119,72122,234
Karachi,2009-06-23,37958,48,38141,75,76099,123,33790,94,33951,103,67742,198
Karachi,2009-06-24,54415,50,55219,57,109634,107,37225,82,37442,88,74668,170
Karachi,2009-06-25,51537,38,50943,59,102480,97,37391,71,37483,78,74875,149
Karachi,2009-06-26,22408,52,22260,48,44668,100,38928,64,39013,70,77941,134
Karachi,2009-06-27,52320,51,52206,42,104526,93,44070,59,44135,61,88206,120
Karachi,2009-06-28,34985,34,34661,50,69646,84,40516,50,40509,59,81025,109
Karachi,2009-06-29,36692,38,37149,47,73841,85,41473,44,41511,54,82984,98
Karachi,2009-06-30,0,45,0,61,0,106,36051,44,36062,52,72113,96
Lebanon,2009-04-16,2672,0,2650,0,5322,0,2672,0,2650,0,5322,0
Lebanon,2009-04-17,3833,0,3707,0,7540,0,3252,0,3178,0,6431,0
Lebanon,2009-04-18,2079,0,2015,0,4094,0,2861,0,2790,0,5652,0
Lebanon,2009-04-19,3696,0,3819,0,7515,0,3070,0,3047,0,6117,0
Lebanon,2009-04-20,6483,1,6518,2,13001,3,3752,0,3741,0,7494,0
Lebanon,2009-04-21,4626,2,4564,1,9190,3,3898,0,3878,0,7777,1
Lebanon,2009-04-22,1384,3,1418,1,2802,4,3539,0,3527,0,7066,1
Lebanon,2009-04-23,5026,2,5092,4,10118,6,3875,1,3876,1,7751,2
Lebanon,2009-04-24,1895,2,1784,5,3679,7,3598,1,3601,1,7199,3
Lebanon,2009-04-25,1965,1,1897,3,3862,4,3582,1,3584,2,7166,3
Lebanon,2009-04-26,2716,3,2690,6,5406,9,3442,2,3423,3,6865,5
Lebanon,2009-04-27,3772,6,3813,5,7585,11,3054,2,3036,3,6091,6
Lebanon,2009-04-28,1320,5,1290,4,2610,9,2582,3,2569,4,5151,7
Lebanon,2009-04-29,2675,8,2711,3,5386,11,2767,3,2753,4,5520,8
Lebanon,2009-04-30,3464,12,3388,5,6852,17,2543,5,2510,4,5054,9
Lebanon,2009-05-01,897,3,915,3,1812,6,2401,5,2386,4,4787,9
Lebanon,2009-05-02,1486,9,1498,4,2984,13,2332,6,2329,4,4662,10
Lebanon,2009-05-03,2038,3,2064,10,4102,13,2236,6,2239,4,4475,11
Lebanon,2009-05-04,1896,11,1833,15,3729,26,1968,7,1957,6,3925,13
Lebanon,2009-05-05,4358,25,4391,17,8749,42,2402,10,2400,8,4802,18
Lebanon,2009-05-06,2858,47,2975,43,5833,90,2428,15,2437,13,4865,29
Lebanon,2009-05-07,3100,52,3109,59,6209,111,2376,21,2397,21,4774,43
Lebanon,2009-05-08,3057,59,3206,64,6263,123,2684,29,2725,30,5409,59
Lebanon,2009-05-09,3172,67,3080,73,6252,140,2925,37,2951,40,5876,77
Lebanon,2009-05-10,2318,74,2267,73,4585,147,2965,47,2980,49,5945,97
Lebanon,2009-05-11,2106,76,1986,80,4092,156,2995,57,3002,58,5997,115
Lebanon,2009-05-12,4970,75,4998,80,9968,155,3083,64,3088,67,6171,131
Lebanon,2009-05-13,2692,92,2620,77,5312,169,3059,70,3038,72,6097,143
Lebanon,2009-05-14,3462,95,3704,84,7166,179,3111,76,3123,75,6234,152
Lebanon,2009-05-15,3860,75,3805,113,7665,188,3225,79,3208,82,6434,162
Lebanon,2009-05-16,4827,96,4849,97,9676,193,3462,83,3461,86,6923,169
Lebanon,2009-05-17,3610,93,3373,99,6983,192,3646,86,3619,90,7266,176
Lebanon,2009-05-18,1273,128,1299,92,2572,220,3527,93,3521,91,7048,185
Lebanon,2009-05-19,5141,132,5026,117,10167,249,3552,101,3525,97,7077,198
Lebanon,2009-05-20,2376,144,2383,129,4759,273,3507,109,3491,104,6998,213
Lebanon,2009-05-21,3829,140,3763,159,7592,299,3559,115,3499,115,7059,230
Lebanon,2009-05-22,1587,155,1638,168,3225,323,3234,126,3190,123,6424,249
Lebanon,2009-05-23,2975,180,2916,158,5891,338,2970,138,2914,131,5884,270
Lebanon,2009-05-24,5872,171,5688,174,11560,345,3293,150,3244,142,6538,292
Lebanon,2009-05-25,958,191,1035,159,1993,350,3248,159,3207,152,6455,311
Lebanon,2009-05-26,2420,167,2340,177,4760,344,2859,164,2823,160,5682,324
Lebanon,2009-05-27,1718,165,1676,162,3394,327,2765,167,2722,165,5487,332
Lebanon,2009-05-28,3988,161,4050,151,8038,312,2788,170,2763,164,5551,334
Lebanon,2009-05-29,4035,144,4084,146,8119,290,3138,168,3112,161,6250,329
Lebanon,2009-05-30,1126,121,1181,146,2307,267,2873,160,2864,159,5738,319
Lebanon,2009-05-31,1396,126,1502,112,2898,238,2234,153,2266,150,4501,304
Lebanon,2009-06-01,2916,105,2936,108,5852,213,2514,141,2538,143,5052,284
Lebanon,2009-06-02,4003,96,4081,88,8084,184,2740,131,2787,130,5527,261
Lebanon,2009-06-03,3876,78,3979,84,7855,162,3048,118,3116,119,6164,238
Lebanon,2009-06-04,4376,64,4382,68,8758,132,3104,104,3163,107,6267,212
Lebanon,2009-06-05,3200,44,3278,70,6478,114,2984,90,3048,96,6033,187
Lebanon,2009-06-06,1957,41,1984,60,3941,101,3103,79,3163,84,6266,163
Lebanon,2009-06-07,4979,39,5059,43,10038,82,3615,66,3671,74,7286,141
Lebanon,2009-06-08,2015,30,2030,37,4045,67,3486,56,3541,64,7028,120
Lebanon,2009-06-09,1870,31,1861,27,3731,58,3181,46,3224,55,6406,102
Lebanon,2009-06-10,3684,20,3692,29,7376,49,3154,38,3183,47,6338,86
Lebanon,2009-06-11,3974,15,3915,25,7889,40,3097,31,3117,41,6214,73
Lebanon,2009-06-12,3395,19,3436,16,6831,35,3124,27,3139,33,6264,61
Lebanon,2009-06-13,1779,16,1887,15,3666,31,3099,24,3125,27,6225,51
Lebanon,2009-06-14,4438,14,4465,9,8903,23,3022,20,3040,22,6063,43
Lebanon,2009-06-15,1853,13,1925,7,3778,20,2999,18,3025,18,6024,36
Lebanon,2009-06-16,1508,8,1565,9,3073,17,2947,15,2983,15,5930,30
Lebanon,2009-06-17,4146,8,4183,8,8329,16,3013,13,3053,12,6067,26
Lebanon,2009-06-18,3148,3,3061,10,6209,13,2895,11,2931,10,5827,22
Lebanon,2009-06-19,3282,3,3346,5,6628,8,2879,9,2918,9,5798,18
Lebanon,2009-06-20,1891,5,1935,8,3826,13,2895,7,2925,8,5820,15
Lebanon,2009-06-21,1918,5,1940,5,3858,10,2535,6,2565,7,5100,13
Lebanon,2009-06-22,3140,2,3307,7,6447,9,2719,4,2762,7,5481,12
Lebanon,2009-06-23,1234,4,1220,3,2454,7,2679,4,2713,6,5393,10
Lebanon,2009-06-24,3721,6,3842,1,7563,7,2619,4,2664,5,5283,9
Lebanon,2009-06-25,1494,5,1552,4,3046,9,2382,4,2448,4,4831,9
Lebanon,2009-06-26,2272,2,2309,4,4581,6,2238,4,2300,4,4539,8
Lebanon,2009-06-27,3213,1,3346,1,6559,2,2427,3,2502,3,4929,7
Lebanon,2009-06-28,2146,3,2172,3,4318,6,2460,3,2535,3,4995,6
Lebanon,2009-06-29,1701,0,1755,5,3456,5,2254,3,2313,3,4568,6
Lebanon,2009-06-30,0,2,0,3,0,5,2078,2,2139,3,4217,5
Nairobi,2009-04-16,8309,0,8199,0,16508,0,8309,0,8199,0,16508,0
Nairobi,2009-04-17,6884,0,7074,0,13958,0,7596,0,7636,0,15233,0
Nairobi,2009-04-18,8122,0,7887,0,16009,0,7771,0,7720,0,15491,0
Nairobi,2009-04-19,6229,2,6436,0,12665,2,7386,0,7399,0,14785,0
Nairobi,2009-04-20,5013,2,4972,0,9985,2,6911,0,6913,0,13825,0
Nairobi,2009-04-21,3244,4,3279,3,6523,7,6300,1,6307,0,12608,1
Nairobi,2009-04-22,7581,1,7568,6,15149,7,6483,1,6487,1,12971,2
Nairobi,2009-04-23,4833,6,4755,4,9588,10,5986,2,5995,1,11982,4
Nairobi,2009-04-24,13063,6,12868,8,25931,14,6869,3,6823,3,13692,6
Nairobi,2009-04-25,7047,6,7013,5,14060,11,6715,3,6698,3,13414,7
Nairobi,2009-04-26,6417,4,6368,4,12785,8,6742,4,6689,4,13431,8
Nairobi,2009-04-27,5647,5,5820,4,11467,9,6833,4,6810,4,13643,9
Nairobi,2009-04-28,10437,11,10339,6,20776,17,7860,5,7818,5,15679,10
Nairobi,2009-04-29,12599,13,12889,10,25488,23,8577,7,8578,5,17156,13
Nairobi,2009-04-30,6898,14,6898,9,13796,23,8872,8,8885,6,17757,15
Nairobi,2009-05-01,9222,19,9343,20,18565,39,8323,10,8381,8,16705,18
Nairobi,2009-05-02,8104,46,8166,43,16270,89,8474,16,8546,13,17021,29
Nairobi,2009-05-03,9729,57,9794,64,19523,121,8948,23,9035,22,17983,45
Nairobi,2009-05-04,7206,186,7006,171,14212,357,9170,49,9205,46,18375,95
Nairobi,2009-05-05,13249,222,13281,211,26530,433,9572,79,9625,75,19197,155
Nairobi,2009-05-06,11841,248,11926,252,23767,500,9464,113,9487,110,18951,223
Nairobi,2009-05-07,7878,274,7920,298,15798,572,9604,150,9633,151,19237,301
Nairobi,2009-05-08,10862,347,10433,320,21295,667,9838,197,9789,194,19627,391
Nairobi,2009-05-09,11306,387,11379,392,22685,779,10295,245,10248,244,20544,489
Nairobi,2009-05-10,10915,432,11159,427,22074,859,10465,299,10443,295,20908,595
Nairobi,2009-05-11,15120,497,15176,445,30296,942,11595,343,11610,335,23206,678
Nairobi,2009-05-12,14004,488,14070,524,28074,1012,11703,381,11723,379,23427,761
Nairobi,2009-05-13,13837,557,13964,557,27801,1114,11988,426,12014,423,24003,849
Nairobi,2009-05-14,13998,614,13974,612,27972,1226,12863,474,12879,468,25742,942
Nairobi,2009-05-15,10703,654,10739,669,21442,1323,12840,518,12923,518,25763,1036
Nairobi,2009-05-16,14313,745,13990,664,28303,1409,13270,569,13296,556,26566,1126
Nairobi,2009-05-17,11175,779,11089,807,22264,1586,13307,619,13286,611,26593,1230
Nairobi,2009-05-18,13909,864,13625,883,27534,1747,13134,671,13064,673,26198,1345
Nairobi,2009-05-19,10436,965,10535,933,20971,1898,12624,739,12559,732,25183,1471
Nairobi,2009-05-20,14347,1016,14046,1000,28393,2016,12697,805,12571,795,25268,1600
Nairobi,2009-05-21,9237,1059,9061,1046,18298,2105,12017,868,11869,857,23886,1726
Nairobi,2009-05-22,9374,1111,9275,1041,18649,2152,11827,934,11660,910,23487,1844
Nairobi,2009-05-23,10975,1071,10914,1081,21889,2152,11350,980,11220,970,22571,1950
Nairobi,2009-05-24,10264,1063,10132,1042,20396,2105,11220,1021,11084,1003,22304,2025
Nairobi,2009-05-25,10094,1022,10136,1000,20230,2022,10675,1043,10585,1020,21260,2064
Nairobi,2009-05-26,8517,907,8416,992,16933,1899,10401,1035,10282,1028,20684,2064
Nairobi,2009-05-27,10712,875,11113,868,21825,1743,9881,1015,9863,1010,19745,2025
Nairobi,2009-05-28,4931,825,4784,752,9715,1577,9266,982,9252,968,18519,1950
Nairobi,2009-05-29,7241,686,7277,715,14518,1401,8962,921,8967,921,17929,1842
Nairobi,2009-05-30,16748,627,16958,602,33706,1229,9786,857,9830,853,19617,1710
Nairobi,2009-05-31,5893,519,5983,547,11876,1066,9162,780,9238,782,18400,1562
Nairobi,2009-06-01,7596,447,7662,471,15258,918,8805,698,8884,706,17690,1404
Nairobi,2009-06-02,8957,409,8948,374,17905,783,8868,626,8960,618,17829,1245
Nairobi,2009-06-03,9364,322,9453,344,18817,666,8675,547,8723,543,17399,1091
Nairobi,2009-06-04,6379,293,6377,265,12756,558,8882,471,8951,474,17833,945
Nairobi,2009-06-05,2157,237,2227,228,4384,465,8156,407,8229,404,16386,812
Nairobi,2009-06-06,274,193,295,192,569,385,5802,345,5849,345,11652,691
Nairobi,2009-06-07,5409,148,5449,173,10858,321,5733,292,5773,292,11506,585
Nairobi,2009-06-08,10892,139,10974,125,21866,264,6204,248,6246,243,12450,491
Nairobi,2009-06-09,9598,117,9600,101,19198,218,6296,207,6339,204,12635,411
Nairobi,2009-06-10,8802,81,8962,90,17764,171,6215,172,6269,167,12485,340
Nairobi,2009-06-11,5479,77,5465,67,10944,144,6087,141,6138,139,12226,281
Nairobi,2009-06-12,7422,65,7647,54,15069,119,6839,117,6913,114,13752,231
Nairobi,2009-06-13,4576,55,4504,56,9080,111,7454,97,7514,95,14968,192
Nairobi,2009-06-14,5701,41,5544,44,11245,85,7495,82,7528,76,15023,158
Nairobi,2009-06-15,8929,48,9133,26,18062,74,7215,69,7265,62,14480,131
Nairobi,2009-06-16,8745,34,8629,31,17374,65,7093,57,7126,52,14219,109
Nairobi,2009-06-17,5258,24,5328,22,10586,46,6587,49,6607,42,13194,92
Nairobi,2009-06-18,5276,24,5398,22,10674,46,6558,41,6597,36,13155,78
Nairobi,2009-06-19,3974,18,3919,23,7893,41,6065,34,6065,32,12130,66
Nairobi,2009-06-20,5044,13,5089,20,10133,33,6132,28,6148,26,12281,55
Nairobi,2009-06-21,6791,17,6686,11,13477,28,6288,25,6311,22,12599,47
Nairobi,2009-06-22,9227,12,9275,7,18502,19,6330,20,6332,19,12662,39
Nairobi,2009-06-23,5596,16,5634,8,11230,24,5880,17,5904,16,11785,33
Nairobi,2009-06-24,7149,9,7125,11,14274,20,6151,15,6160,14,12311,30
Nairobi,2009-06-25,4900,6,4914,4,9814,10,6097,13,6091,12,12189,25
Nairobi,2009-06-26,10887,11,10682,5,21569,16,7084,12,7057,9,14142,21
Nairobi,2009-06-27,4873,2,4977,9,9850,11,7060,10,7041,7,14102,18
Nairobi,2009-06-28,9720,5,9544,9,19264,14,7478,8,7450,7,14929,16
Nairobi,2009-06-29,8190,10,7962,7,16152,17,7330,8,7262,7,14593,16
Nairobi,2009-06-30,0,3,0,11,0,14,6531,6,6457,8,12989,14
Saudiarabia,2009-04-16,7539,0,7708,0,15247,0,7539,0,7708,0,15247,0
Saudiarabia,2009-04-17,8674,0,8697,0,17371,0,8106,0,8202,0,16309,0
Saudiarabia,2009-04-18,3990,0,3970,0,7960,0,6734,0,6791,0,13526,0
Saudiarabia,2009-04-19,4238,1,4297,0,8535,1,6110,0,6168,0,12278,0
Saudiarabia,2009-04-20,6628,4,6891,2,13519,6,6213,1,6312,0,12526,1
Saudiarabia,2009-04-21,15035,6,15085,7,30120,13,7684,1,7774,1,15458,3
Saudiarabia,2009-04-22,11458,6,11480,6,22938,12,8223,2,8304,2,16527,4
Saudiarabia,2009-04-23,6046,4,6039,10,12085,14,8009,3,8065,3,16075,6
Saudiarabia,2009-04-24,7886,4,7983,10,15869,14,7897,3,7963,5,15860,8
Saudiarabia,2009-04-25,8700,8,8770,8,17470,16,8570,4,8649,6,17219,10
Saudiarabia,2009-04-26,207,12,224,13,431,25,7994,6,8067,8,16061,14
Saudiarabia,2009-04-27,9680,8,9739,15,19419,23,8430,6,8474,9,16904,16
Saudiarabia,2009-04-28,10292,5,10266,10,20558,15,7752,6,7785,10,15538,17
Saudiarabia,2009-04-29,14627,10,14637,9,29264,19,8205,7,8236,10,16442,18
Saudiarabia,2009-04-30,7394,8,7422,5,14816,13,8398,7,8434,10,16832,17
Saudiarabia,2009-05-01,10668,6,11008,6,21676,12,8795,8,8866,9,17662,17
Saudiarabia,2009-05-02,5491,4,5586,7,11077,11,8337,7,8411,9,16748,16
Saudiarabia,2009-05-03,7393,15,7266,12,14659,27,9363,8,9417,9,18781,17
Saudiarabia,2009-05-04,7211,11,7272,19,14483,30,9010,8,9065,9,18076,18
Saudiarabia,2009-05-05,9584,34,9702,40,19286,74,8909,12,8984,14,17894,26
Saudiarabia,2009-05-06,9885,34,9894,44,19779,78,8232,16,8307,19,16539,35
Saudiarabia,2009-05-07,13181,123,13110,106,26291,229,9059,32,9119,33,18178,65
Saudiarabia,2009-05-08,7673,149,7644,132,15317,281,8631,52,8639,51,17270,104
Saudiarabia,2009-05-09,13287,153,13410,160,26697,313,9744,74,9756,73,19501,147
Saudiarabia,2009-05-10,13566,147,13552,194,27118,341,10626,93,10654,99,21281,192
Saudiarabia,2009-05-11,12668,170,12510,176,25178,346,11406,115,11403,121,22809,237
Saudiarabia,2009-05-12,6890,171,6902,205,13792,376,11021,135,11003,145,22024,280
Saudiarabia,2009-05-13,10079,177,9959,196,20038,373,11049,155,11012,167,22061,322
Saudiarabia,2009-05-14,9798,186,9856,248,19654,434,10565,164,10547,187,21113,352
Saudiarabia,2009-05-15,10129,226,10227,234,20356,460,10916,175,10916,201,21833,377
Saudiarabia,2009-05-16,7419,255,7330,249,14749,504,10078,190,10048,214,20126,404
Saudiarabia,2009-05-17,6254,271,6364,270,12618,541,9033,208,9021,225,18055,433
Saudiarabia,2009-05-18,13171,263,13144,303,26315,566,9105,221,9111,243,18217,464
Saudiarabia,2009-05-19,14971,320,14844,320,29815,640,10260,242,10246,260,20506,502
Saudiarabia,2009-05-20,10538,347,10469,375,21007,722,10325,266,10319,285,20644,552
Saudiarabia,2009-05-21,11362,404,11324,396,22686,800,10549,298,10528,306,21078,604
Saudiarabia,2009-05-22,9115,418,9221,457,18336,875,10404,325,10385,338,20789,664
Saudiarabia,2009-05-23,12932,472,12902,466,25834,938,11191,356,11181,369,22373,726
Saudiarabia,2009-05-24,12244,511,12256,478,24500,989,12047,390,12022,399,24070,790
Saudiarabia,2009-05-25,8207,492,8176,529,16383,1021,11338,423,11313,431,22651,855
Saudiarabia,2009-05-26,6140,519,6296,502,12436,1021,10076,451,10092,457,20168,909
Saudiarabia,2009-05-27,10489,514,10690,492,21179,1006,10069,475,10123,474,20193,950
Saudiarabia,2009-05-28,12806,479,12892,489,25698,968,10276,486,10347,487,20623,974
Saudiarabia,2009-05-29,11180,433,10923,481,22103,914,10571,488,10590,491,21161,979
Saudiarabia,2009-05-30,7958,425,7907,414,15865,839,9860,481,9877,483,19737,965
Saudiarabia,2009-05-31,11522,393,11506,380,23028,773,9757,465,9770,469,19527,934
Saudiarabia,2009-06-01,6705,345,6822,343,13527,688,9542,444,9576,443,19119,887
Saudiarabia,2009-06-02,6211,317,6169,294,12380,611,9553,415,9558,413,19111,828
Saudiarabia,2009-06-03,7533,277,7434,250,14967,527,9130,381,9093,378,18224,760
Saudiarabia,2009-06-04,5309,215,5437,243,10746,458,8059,343,8028,343,16088,687
Saudiarabia,2009-06-05,12599,212,12295,177,24894,389,8262,312,8224,300,16486,612
Saudiarabia,2009-06-06,5327,173,5403,157,10730,330,7886,276,7866,263,15753,539
Saudiarabia,2009-06-07,7893,138,7641,151,15534,289,7368,239,7314,230,14682,470
Saudiarabia,2009-06-08,9388,129,9229,109,18617,238,7751,208,7658,197,15409,406
Saudiarabia,2009-06-09,8563,103,8688,99,17251,202,8087,178,8018,169,16105,347
Saudiarabia,2009-06-10,11236,84,11264,76,22500,160,8616,150,8565,144,17181,295
Saudiarabia,2009-06-11,8458,67,8700,73,17158,140,9066,129,9031,120,18097,249
Saudiarabia,2009-06-12,7443,55,7343,62,14786,117,8329,107,8324,103,16653,210
Saudiarabia,2009-06-13,10320,49,10377,52,20697,101,9043,89,9034,88,18077,178
Saudiarabia,2009-06-14,1938,55,2059,40,3997,95,8192,77,8237,73,16429,150
Saudiarabia,2009-06-15,7294,39,7640,36,14934,75,7893,64,8010,62,15903,127
Saudiarabia,2009-06-16,2055,32,2045,30,4100,62,6963,54,7061,52,14024,107
Saudiarabia,2009-06-17,7498,25,7510,22,15008,47,6429,46,6524,45,12954,91
Saudiarabia,2009-06-18,3130,19,3153,24,6283,43,5668,39,5732,38,11400,77
Saudiarabia,2009-06-19,8956,24,9072,22,18028,46,5884,34,5979,32,11863,67
Saudiarabia,2009-06-20,10841,18,10713,15,21554,33,5958,30,6027,27,11986,57
Saudiarabia,2009-06-21,9010,12,9190,9,18200,21,6969,24,7046,22,14015,46
Saudiarabia,2009-06-22,8557,8,8767,15,17324,23,7149,19,7207,19,14356,39
Saudiarabia,2009-06-23,7962,12,8189,8,16151,20,7993,16,8084,16,16078,33
Saudiarabia,2009-06-24,7679,8,7755,18,15434,26,8019,14,8119,15,16139,30
Saudiarabia,2009-06-25,11337,11,11422,13,22759,24,9191,13,9301,14,18492,27
Saudiarabia,2009-06-26,9957,6,10010,15,19967,21,9334,10,9435,13,18769,24
Saudiarabia,2009-06-27,7663,7,7702,8,15365,15,8880,9,9005,12,17885,21
Saudiarabia,2009-06-28,7125,10,7072,10,14197,20,8611,8,8702,12,17313,21
Saudiarabia,2009-06-29,8481,4,8438,9,16919,13,8600,8,8655,11,17256,19
Saudiarabia,2009-06-30,0,14,0,8,0,22,7463,8,7485,11,14948,20
Thailand,2009-04-16,645,0,647,0,1292,0,645,0,647,0,1292,0
Thailand,2009-04-17,327,0,312,0,639,0,486,0,479,0,965,0
Thailand,2009-04-18,876,0,885,0,1761,0,616,0,614,0,1230,0
Thailand,2009-04-19,546,0,561,0,1107,0,598,0,601,0,1199,0
Thailand,2009-04-21,273,0,286,0,559,0,533,0,538,0,1071,0
Thailand,2009-04-22,818,0,874,1,1692,1,580,0,594,0,1175,0
Thailand,2009-04-23,191,1,189,1,380,2,525,0,536,0,1061,0
Thailand,2009-04-24,440,0,471,0,911,0,495,0,511,0,1007,0
Thailand,2009-04-25,717,0,734,1,1451,1,551,0,571,0,1123,0
Thailand,2009-04-26,265,0,288,0,553,0,464,0,486,0,950,0
Thailand,2009-04-27,979,1,1001,3,1980,4,526,0,549,0,1075,1
Thailand,2009-04-28,537,0,530,1,1067,1,563,0,583,1,1147,1
Thailand,2009-04-29,93,0,97,0,190,0,460,0,472,0,933,1
Thailand,2009-04-30,731,1,676,1,1407,2,537,0,542,0,1079,1
Thailand,2009-05-01,979,1,994,1,1973,2,614,0,617,1,1231,1
Thailand,2009-05-02,588,1,556,0,1144,1,596,0,591,0,1187,1
Thailand,2009-05-03,522,0,531,3,1053,3,632,0,626,1,1259,1
Thailand,2009-05-04,821,1,851,1,1672,2,610,0,605,1,1215,1
Thailand,2009-05-05,531,3,523,1,1054,4,609,1,604,1,1213,2
Thailand,2009-05-06,435,1,463,1,898,2,658,1,656,1,1314,2
Thailand,2009-05-07,216,1,187,0,403,1,584,1,586,1,1171,2
Thailand,2009-05-08,331,1,365,1,696,2,492,1,496,1,988,2
Thailand,2009-05-09,838,1,836,1,1674,2,527,1,536,1,1064,2
Thailand,2009-05-10,997,1,1009,0,2006,1,595,1,604,0,1200,2
Thailand,2009-05-11,802,0,834,0,1636,0,592,1,602,0,1195,1
Thailand,2009-05-12,664,0,648,1,1312,1,611,0,620,0,1232,1
Thailand,2009-05-13,587,0,611,0,1198,0,633,0,641,0,1275,1
Thailand,2009-05-14,519,1,461,1,980,2,676,0,680,0,1357,1
Thailand,2009-05-15,723,2,765,1,1488,3,732,0,737,0,1470,1
Thailand,2009-05-16,842,1,798,2,1640,3,733,0,732,0,1465,1
Thailand,2009-05-17,658,0,594,2,1252,2,685,0,673,1,1358,1
Thailand,2009-05-18,331,1,301,0,632,1,617,0,596,1,1214,1
Thailand,2009-05-19,725,1,716,2,1441,3,626,0,606,1,1233,2
Thailand,2009-05-20,78,1,92,0,170,1,553,1,532,1,1086,2
Thailand,2009-05-21,1099,0,969,1,2068,1,636,0,605,1,1241,2
Thailand,2009-05-22,790,0,788,0,1578,0,646,0,608,1,1254,1
Thailand,2009-05-23,131,0,117,0,248,0,544,0,511,0,1055,1
Thailand,2009-05-24,761,0,784,0,1545,0,559,0,538,0,1097,0
Thailand,2009-05-25,684,1,647,0,1331,1,609,0,587,0,1197,0
Thailand,2009-05-26,656,2,660,0,1316,2,599,0,579,0,1179,0
Thailand,2009-05-27,667,0,716,0,1383,0,684,0,668,0,1352,0
Thailand,2009-05-28,751,0,698,2,1449,2,634,0,630,0,1264,0
Thailand,2009-05-29,805,0,736,0,1541,0,636,0,622,0,1259,0
Thailand,2009-05-30,1030,1,978,0,2008,1,764,0,745,0,1510,0
Thailand,2009-05-31,460,0,428,1,888,1,721,0,694,0,1416,1
Thailand,2009-06-01,883,1,878,1,1761,2,750,0,727,0,1478,1
Thailand,2009-06-02,487,0,467,1,954,1,726,0,700,0,1426,1
Thailand,2009-06-03,374,0,345,1,719,1,684,0,647,0,1331,1
Thailand,2009-06-04,590,0,580,2,1170,2,661,0,630,0,1291,1
Thailand,2009-06-05,801,0,750,2,1551,2,660,0,632,1,1293,1
Thailand,2009-06-06,698,1,683,0,1381,1,613,0,590,1,1203,1
Thailand,2009-06-07,809,0,658,0,1467,0,663,0,623,1,1286,1
Thailand,2009-06-08,898,0,915,1,1813,1,665,0,628,1,1293,1
Thailand,2009-06-09,134,1,123,0,257,1,614,0,579,0,1194,1
Thailand,2009-06-10,895,0,863,0,1758,0,689,0,653,0,1342,1
Thailand,2009-06-11,869,3,850,0,1719,3,729,0,691,0,1420,1
Thailand,2009-06-12,422,0,489,0,911,0,675,0,654,0,1329,0
Thailand,2009-06-13,247,1,263,2,510,3,610,0,594,0,1205,1
Thailand,2009-06-14,243,0,239,1,482,1,529,0,534,0,1064,1
Thailand,2009-06-15,623,1,623,0,1246,1,490,0,492,0,983,1
Thailand,2009-06-16,813,0,828,1,1641,1,587,0,593,0,1181,1
Thailand,2009-06-17,803,0,787,1,1590,1,574,0,582,0,1157,1
Thailand,2009-06-18,398,0,386,0,784,0,507,0,516,0,1023,1
Thailand,2009-06-19,1330,0,1316,1,2646,1,636,0,634,0,1271,1
Thailand,2009-06-20,401,0,370,0,771,0,658,0,649,0,1308,0
Thailand,2009-06-21,595,0,595,2,1190,2,709,0,700,0,1409,0
Thailand,2009-06-22,476,1,485,1,961,2,688,0,681,0,1369,1
Thailand,2009-06-23,567,0,596,1,1163,1,652,0,647,0,1300,1
Thailand,2009-06-24,256,1,225,0,481,1,574,0,567,0,1142,1
Thailand,2009-06-25,129,1,95,1,224,2,536,0,526,0,1062,1
Thailand,2009-06-26,357,0,370,0,727,0,397,0,390,0,788,1
Thailand,2009-06-27,739,0,738,1,1477,1,445,0,443,0,889,1
Thailand,2009-06-28,388,0,356,0,744,0,416,0,409,0,825,1
Thailand,2009-06-29,872,0,821,0,1693,0,472,0,457,0,929,0
Turkey,2009-04-16,1449,0,1485,0,2934,0,1449,0,1485,0,2934,0
Turkey,2009-04-17,2960,0,2865,0,5825,0,2204,0,2175,0,4379,0
Turkey,2009-04-18,1363,0,1404,0,2767,0,1924,0,1918,0,3842,0
Turkey,2009-04-19,727,0,753,1,1480,1,1624,0,1626,0,3251,0
Turkey,2009-04-20,1394,0,1492,1,2886,1,1578,0,1599,0,3178,0
Turkey,2009-04-21,1055,2,1022,0,2077,2,1491,0,1503,0,2994,0
Turkey,2009-04-22,1770,0,1832,1,3602,1,1531,0,1550,0,3081,0
Turkey,2009-04-23,1963,3,2034,2,3997,5,1604,0,1628,0,3233,1
Turkey,2009-04-24,1903,2,1891,0,3794,2,1453,1,1489,0,2943,1
Turkey,2009-04-25,2353,0,2344,1,4697,1,1595,1,1624,0,3219,1
Turkey,2009-04-26,2915,0,2954,0,5869,0,1907,1,1938,0,3846,1
Turkey,2009-04-27,1489,0,1452,2,2941,2,1921,1,1932,0,3853,1
Turkey,2009-04-28,710,0,667,1,1377,1,1871,0,1882,1,3753,1
Turkey,2009-04-29,1854,4,1902,1,3756,5,1883,1,1892,1,3775,2
Turkey,2009-04-30,2605,4,2755,3,5360,7,1975,1,1995,1,3970,2
Turkey,2009-05-01,4173,2,4249,1,8422,3,2299,1,2331,1,4631,2
Turkey,2009-05-02,733,2,738,2,1471,4,2068,1,2102,1,4170,3
Turkey,2009-05-03,2149,1,2251,1,4400,2,1959,1,2002,1,3961,3
Turkey,2009-05-04,1930,2,1961,2,3891,4,2022,2,2074,1,4096,3
Turkey,2009-05-05,1354,2,1377,6,2731,8,2114,2,2176,2,4290,4
Turkey,2009-05-06,1027,2,1067,1,2094,3,1995,2,2056,2,4052,4
Turkey,2009-05-07,3205,2,3139,2,6344,4,2081,1,2111,2,4193,4
Turkey,2009-05-08,3136,3,3217,0,6353,3,1933,2,1964,2,3897,4
Turkey,2009-05-09,1580,1,1640,2,3220,3,2054,1,2093,2,4147,3
Turkey,2009-05-10,2921,1,2975,1,5896,2,2164,1,2196,2,4361,3
Turkey,2009-05-11,3090,4,3015,2,6105,6,2330,2,2347,2,4677,4
Turkey,2009-05-12,1631,3,1598,4,3229,7,2370,2,2378,1,4748,4
Turkey,2009-05-13,2122,2,2134,4,4256,6,2526,2,2531,2,5057,4
Turkey,2009-05-14,2040,3,2062,4,4102,7,2360,2,2377,2,4737,4
Turkey,2009-05-15,1455,3,1462,4,2917,7,2119,2,2126,3,4246,5
Turkey,2009-05-16,3419,3,3290,3,6709,6,2382,2,2362,3,4744,5
Turkey,2009-05-17,1203,2,1221,4,2424,6,2137,2,2111,3,4248,6
Turkey,2009-05-18,2252,0,2223,4,4475,4,2017,2,1998,3,4016,6
Turkey,2009-05-19,2423,2,2336,1,4759,3,2130,2,2104,3,4234,5
Turkey,2009-05-20,2605,4,2571,1,5176,5,2199,2,2166,3,4366,5
Turkey,2009-05-21,1386,2,1406,6,2792,8,2106,2,2072,3,4178,5
Turkey,2009-05-22,2484,1,2422,2,4906,3,2253,2,2209,3,4463,5
Turkey,2009-05-23,1816,2,1708,2,3524,4,2024,1,1983,2,4008,4
Turkey,2009-05-24,2439,5,2386,2,4825,7,2200,2,2150,2,4351,4
Turkey,2009-05-25,0,3,0,1,0,4,1879,2,1832,2,3711,4
Turkey,2009-05-26,2265,2,2267,0,4532,2,1856,2,1822,2,3679,4
Turkey,2009-05-27,2942,0,2900,2,5842,2,1904,2,1869,2,3774,4
Turkey,2009-05-28,2774,1,2801,2,5575,3,2102,2,2069,1,4172,3
Turkey,2009-05-29,2764,5,2723,0,5487,5,2142,2,2112,1,4255,3
Turkey,2009-05-30,3246,1,3340,3,6586,4,2347,2,2345,1,4692,3
Turkey,2009-05-31,3150,1,3151,2,6301,3,2448,1,2454,1,4903,3
Turkey,2009-06-01,985,2,965,3,1950,5,2589,1,2592,1,5181,3
Turkey,2009-06-02,2647,4,2624,1,5271,5,2644,2,2643,1,5287,3
Turkey,2009-06-03,2312,5,2286,3,4598,8,2554,2,2555,2,5109,4
Turkey,2009-06-04,2162,1,2188,3,4350,4,2466,2,2468,2,4934,4
Turkey,2009-06-05,894,2,958,1,1852,3,2199,2,2216,2,4415,4
Turkey,2009-06-06,2345,7,2290,0,4635,7,2070,3,2066,1,4136,5
Turkey,2009-06-07,1114,3,1025,1,2139,4,1779,3,1762,1,3542,5
Turkey,2009-06-08,1793,1,1765,0,3558,1,1895,3,1876,1,3771,4
Turkey,2009-06-09,1388,5,1442,3,2830,8,1715,3,1707,1,3423,5
Turkey,2009-06-10,1135,3,1126,1,2261,4,1547,3,1542,1,3089,4
Turkey,2009-06-11,1711,2,1787,3,3498,5,1482,3,1484,1,2967,4
Turkey,2009-06-12,3381,1,3294,1,6675,2,1838,3,1818,1,3656,4
Turkey,2009-06-13,1654,3,1697,1,3351,4,1739,2,1733,1,3473,4
Turkey,2009-06-14,976,1,1016,3,1992,4,1719,2,1732,1,3452,4
Turkey,2009-06-15,2821,2,2713,3,5534,5,1866,2,1867,2,3734,4
Turkey,2009-06-16,1390,1,1321,1,2711,2,1866,1,1850,1,3717,3
Turkey,2009-06-17,1185,2,1258,1,2443,3,1874,1,1869,1,3743,3
Turkey,2009-06-18,2712,4,2702,3,5414,7,2017,2,2000,1,4017,3
Turkey,2009-06-19,1530,2,1559,0,3089,2,1752,2,1752,1,3504,3
Turkey,2009-06-20,1211,0,1189,0,2400,0,1689,1,1679,1,3369,3
Turkey,2009-06-21,1486,2,1473,2,2959,4,1762,1,1745,1,3507,3
Turkey,2009-06-22,2439,0,2299,1,4738,1,1707,1,1685,1,3393,2
Turkey,2009-06-23,2348,3,2328,0,4676,3,1844,1,1829,1,3674,2
Turkey,2009-06-24,2899,4,2885,3,5784,7,2089,2,2062,1,4151,3
Turkey,2009-06-25,1663,0,1610,2,3273,2,1939,1,1906,1,3845,2
Turkey,2009-06-26,2130,1,2145,1,4275,2,2025,1,1989,1,4015,2
Turkey,2009-06-27,3447,0,3388,0,6835,0,2344,1,2304,1,4648,2
Turkey,2009-06-28,1365,5,1351,1,2716,6,2327,1,2286,1,4613,3
Turkey,2009-06-29,2717,2,2757,1,5474,3,2367,2,2352,1,4719,3
Turkey,2009-06-30,0,2,0,1,0,3,2031,2,2019,1,4051,3
Venezuela,2009-04-16,230,0,209,0,439,0,230,0,209,0,439,0
Venezuela,2009-04-17,1173,0,1203,0,2376,0,701,0,706,0,1407,0
Venezuela,2009-04-18,963,0,897,1,1860,1,788,0,769,0,1558,0
Venezuela,2009-04-19,399,0,421,0,820,0,691,0,682,0,1373,0
Venezuela,2009-04-20,0,0,0,1,0,1,553,0,546,0,1099,0
Venezuela,2009-04-21,860,0,862,2,1722,2,604,0,598,0,1202,0
Venezuela,2009-04-22,307,3,371,0,678,3,561,0,566,0,1127,1
Venezuela,2009-04-23,2123,0,2126,0,4249,0,832,0,840,0,1672,1
Venezuela,2009-04-24,821,1,790,1,1611,2,781,0,781,0,1562,1
Venezuela,2009-04-25,1342,0,1281,2,2623,2,836,0,835,0,1671,1
Venezuela,2009-04-26,872,0,872,0,1744,0,903,0,900,0,1803,1
Venezuela,2009-04-27,813,1,806,1,1619,2,1019,0,1015,0,2035,1
Venezuela,2009-04-28,1207,0,1167,2,2374,2,1069,0,1059,0,2128,1
Venezuela,2009-04-29,304,0,314,1,618,1,1068,0,1050,1,2119,1
Venezuela,2009-04-30,618,2,677,1,1295,3,853,0,843,1,1697,1
Venezuela,2009-05-01,650,0,604,3,1254,3,829,0,817,1,1646,1
Venezuela,2009-05-02,1209,1,1200,1,2409,2,810,0,805,1,1616,1
Venezuela,2009-05-03,857,0,921,1,1778,1,808,0,812,1,1621,2
Venezuela,2009-05-04,987,1,935,3,1922,4,833,0,831,1,1664,2
Venezuela,2009-05-05,1427,5,1509,4,2936,9,864,1,880,2,1744,3
Venezuela,2009-05-06,1307,9,1295,5,2602,14,1007,2,1020,2,2028,5
Venezuela,2009-05-07,891,15,817,10,1708,25,1046,4,1040,3,2087,8
Venezuela,2009-05-08,653,19,694,25,1347,44,1047,7,1053,7,2100,14
Venezuela,2009-05-09,1049,24,985,30,2034,54,1024,10,1022,11,2046,21
Venezuela,2009-05-10,728,29,732,31,1460,60,1006,14,995,15,2001,30
Venezuela,2009-05-11,1200,32,1255,35,2455,67,1036,19,1041,20,2077,39
Venezuela,2009-05-12,1180,36,1154,35,2334,71,1001,23,990,24,1991,47
Venezuela,2009-05-13,1845,28,1830,43,3675,71,1078,26,1066,29,2144,56
Venezuela,2009-05-14,915,44,904,31,1819,75,1081,30,1079,32,2160,63
Venezuela,2009-05-15,1022,40,962,37,1984,77,1134,33,1117,34,2251,67
Venezuela,2009-05-16,884,44,880,40,1764,84,1110,36,1102,36,2213,72
Venezuela,2009-05-17,1442,49,1437,41,2879,90,1212,39,1203,37,2415,76
Venezuela,2009-05-18,1683,50,1723,52,3406,102,1281,41,1270,39,2551,81
Venezuela,2009-05-19,1775,57,1854,53,3629,110,1366,44,1370,42,2736,87
Venezuela,2009-05-20,1125,60,1186,61,2311,121,1263,49,1278,45,2541,94
Venezuela,2009-05-21,826,68,855,61,1681,129,1251,52,1271,49,2522,101
Venezuela,2009-05-22,1664,67,1694,67,3358,134,1342,56,1375,53,2718,110
Venezuela,2009-05-23,1854,84,1936,66,3790,150,1481,62,1526,57,3007,119
Venezuela,2009-05-24,852,79,872,80,1724,159,1397,66,1445,62,2842,129
Venezuela,2009-05-25,1445,73,1508,95,2953,168,1363,69,1415,69,2778,138
Venezuela,2009-05-26,1415,90,1306,80,2721,170,1311,74,1336,72,2648,147
Venezuela,2009-05-27,733,86,788,85,1521,171,1255,78,1279,76,2535,154
Venezuela,2009-05-28,998,85,1017,82,2015,167,1280,80,1303,79,2583,159
Venezuela,2009-05-29,756,73,772,88,1528,161,1150,81,1171,82,2321,163
Venezuela,2009-05-30,258,76,229,76,487,152,922,80,927,83,1849,164
Venezuela,2009-05-31,998,80,985,60,1983,140,943,80,943,80,1886,161
Venezuela,2009-06-01,1096,71,1078,57,2174,128,893,80,882,75,1775,155
Venezuela,2009-06-02,953,61,909,52,1862,113,827,76,825,71,1652,147
Venezuela,2009-06-03,816,50,875,49,1691,99,839,70,837,66,1677,137
Venezuela,2009-06-04,249,46,248,42,497,88,732,65,728,60,1460,125
Venezuela,2009-06-05,165,33,170,41,335,74,647,59,642,53,1289,113
Venezuela,2009-06-06,1251,29,1233,38,2484,67,789,52,785,48,1575,101
Venezuela,2009-06-07,791,26,767,28,1558,54,760,45,754,43,1514,89
Venezuela,2009-06-08,687,18,680,29,1367,47,701,37,697,39,1399,77
Venezuela,2009-06-09,804,14,831,25,1635,39,680,30,686,36,1366,66
Venezuela,2009-06-10,1297,12,1347,19,2644,31,749,25,753,31,1502,57
Venezuela,2009-06-11,1214,9,1264,16,2478,25,887,20,898,28,1785,48
Venezuela,2009-06-12,176,13,220,8,396,21,888,17,906,23,1794,40
Venezuela,2009-06-13,763,9,714,9,1477,18,818,14,831,19,1650,33
Venezuela,2009-06-14,1049,10,1101,8,2150,18,855,12,879,16,1735,28
Venezuela,2009-06-15,922,7,976,6,1898,13,889,10,921,13,1811,23
Venezuela,2009-06-16,687,7,666,5,1353,12,872,9,898,10,1770,19
Venezuela,2009-06-17,735,4,743,5,1478,9,792,8,812,8,1604,16
Venezuela,2009-06-18,962,6,864,2,1826,8,756,8,754,6,1511,14
Venezuela,2009-06-19,966,6,1053,3,2019,9,869,7,873,5,1743,12
Venezuela,2009-06-20,704,3,705,3,1409,6,860,6,872,4,1733,10
Venezuela,2009-06-21,1006,1,985,2,1991,3,854,4,856,3,1710,8
Venezuela,2009-06-22,1381,2,1368,5,2749,7,920,4,912,3,1832,7
Venezuela,2009-06-23,424,3,409,2,833,5,882,3,875,3,1757,6
Venezuela,2009-06-24,1055,3,1083,2,2138,5,928,3,923,2,1852,6
Venezuela,2009-06-25,978,1,1028,0,2006,1,930,2,947,2,1877,5
Venezuela,2009-06-26,796,2,906,1,1702,3,906,2,926,2,1832,4
Venezuela,2009-06-27,831,3,723,0,1554,3,924,2,928,1,1853,3
Venezuela,2009-06-28,1807,5,1712,2,3519,7,1038,2,1032,1,2071,4
Venezuela,2009-06-29,539,0,549,0,1088,0,918,2,915,1,1834,3
Yemen,2009-04-16,1011,0,945,0,1956,0,1011,0,945,0,1956,0
Yemen,2009-04-17,1312,0,1397,0,2709,0,1161,0,1171,0,2332,0
Yemen,2009-04-18,1341,0,1339,0,2680,0,1221,0,1227,0,2448,0
Yemen,2009-04-19,2152,0,2147,0,4299,0,1454,0,1457,0,2911,0
Yemen,2009-04-20,1181,0,1213,0,2394,0,1399,0,1408,0,2807,0
Yemen,2009-04-21,1654,1,1683,0,3337,1,1441,0,1454,0,2895,0
Yemen,2009-04-22,1557,2,1642,4,3199,6,1458,0,1480,0,2939,1
Yemen,2009-04-23,1428,0,1421,0,2849,0,1517,0,1548,0,3066,1
Yemen,2009-04-24,994,0,1085,6,2079,6,1472,0,1504,1,2976,1
Yemen,2009-04-25,2034,3,2110,1,4144,4,1571,0,1614,1,3185,2
Yemen,2009-04-26,1880,0,1779,2,3659,2,1532,0,1561,1,3094,2
Yemen,2009-04-27,1623,0,1642,0,3265,0,1595,0,1623,1,3218,2
Yemen,2009-04-28,1448,0,1597,3,3045,3,1566,0,1610,2,3177,3
Yemen,2009-04-29,1397,2,1429,2,2826,4,1543,0,1580,2,3123,2
Yemen,2009-04-30,2028,1,1983,0,4011,1,1629,0,1660,2,3289,2
Yemen,2009-05-01,2640,2,2617,2,5257,4,1864,1,1879,1,3743,2
Yemen,2009-05-02,1634,3,1655,5,3289,8,1807,1,1814,2,3621,3
Yemen,2009-05-03,994,7,944,4,1938,11,1680,2,1695,2,3375,4
Yemen,2009-05-04,3059,7,3121,9,6180,16,1885,3,1906,3,3792,6
Yemen,2009-05-05,1552,14,1499,11,3051,25,1900,5,1892,4,3793,9
Yemen,2009-05-06,2602,13,2570,30,5172,43,2072,6,2055,8,4128,15
Yemen,2009-05-07,1789,30,1766,26,3555,56,2038,10,2024,12,4063,23
Yemen,2009-05-08,1617,30,1577,32,3194,62,1892,14,1876,16,3768,31
Yemen,2009-05-09,2013,39,2084,34,4097,73,1946,20,1937,20,3883,40
Yemen,2009-05-10,2930,43,2806,48,5736,91,2223,25,2203,27,4426,52
Yemen,2009-05-11,2208,50,2260,51,4468,101,2101,31,2080,33,4181,64
Yemen,2009-05-12,2877,57,2866,61,5743,118,2290,37,2275,40,4566,77
Yemen,2009-05-13,2444,75,2506,59,4950,134,2268,46,2266,44,4534,90
Yemen,2009-05-14,3185,84,3200,70,6385,154,2467,54,2471,50,4939,104
Yemen,2009-05-15,3493,88,3487,92,6980,180,2735,62,2744,59,5479,121
Yemen,2009-05-16,3799,103,3778,102,7577,205,2990,71,2986,69,5977,140
Yemen,2009-05-17,3743,120,3765,111,7508,231,3107,82,3123,78,6230,160
Yemen,2009-05-18,3610,138,3642,125,7252,263,3307,95,3320,88,6627,183
Yemen,2009-05-19,3332,151,3327,142,6659,293,3372,108,3386,100,6758,208
Yemen,2009-05-20,2938,168,2873,156,5811,324,3442,121,3438,114,6881,235
Yemen,2009-05-21,1975,173,2023,180,3998,353,3270,134,3270,129,6540,264
Yemen,2009-05-22,1687,183,1714,192,3401,375,3012,148,3017,144,6029,292
Yemen,2009-05-23,3424,191,3499,201,6923,392,2958,160,2977,158,5936,318
Yemen,2009-05-24,3543,191,3604,203,7147,394,2929,170,2954,171,5884,342
Yemen,2009-05-25,2310,195,2291,199,4601,394,2744,178,2761,181,5505,360
Yemen,2009-05-26,2326,194,2380,189,4706,383,2600,185,2626,188,5226,373
Yemen,2009-05-27,2403,192,2377,171,4780,363,2524,188,2555,190,5079,379
Yemen,2009-05-28,431,166,438,176,869,342,2303,187,2329,190,4632,377
Yemen,2009-05-29,2848,159,2888,152,5736,311,2469,184,2496,184,4966,368
Yemen,2009-05-30,1760,140,1774,144,3534,284,2231,176,2250,176,4481,353
Yemen,2009-05-31,1972,138,1914,112,3886,250,2007,169,2008,163,4016,332
Yemen,2009-06-01,2120,103,2200,118,4320,221,1980,156,1995,151,3975,307
Yemen,2009-06-02,2058,92,2006,98,4064,190,1941,141,1942,138,3884,280
Yemen,2009-06-03,1135,77,1147,88,2282,165,1760,125,1766,126,3527,251
Yemen,2009-06-04,1771,69,1805,67,3576,136,1952,111,1962,111,3914,222
Yemen,2009-06-05,898,54,923,62,1821,116,1673,96,1681,98,3354,194
Yemen,2009-06-06,2153,59,2154,40,4307,99,1729,84,1735,83,3465,168
Yemen,2009-06-07,1329,39,1301,49,2630,88,1637,70,1648,74,3285,145
Yemen,2009-06-08,1091,35,1127,36,2218,71,1490,60,1494,62,2985,123
Yemen,2009-06-09,1627,30,1596,28,3223,58,1429,51,1436,52,2865,104
Yemen,2009-06-10,882,23,905,23,1787,46,1393,44,1401,43,2794,87
Yemen,2009-06-11,1095,16,1124,24,2219,40,1296,36,1304,37,2600,74
Yemen,2009-06-12,1901,20,1889,11,3790,31,1439,31,1442,30,2882,61
Yemen,2009-06-13,2024,15,2089,14,4113,29,1421,25,1433,26,2854,51
Yemen,2009-06-14,1929,10,1722,10,3651,20,1507,21,1493,20,3000,42
Yemen,2009-06-15,1453,10,1607,7,3060,17,1558,17,1561,16,3120,34
Yemen,2009-06-16,2323,6,2360,15,4683,21,1658,14,1670,14,3329,29
Yemen,2009-06-17,892,6,896,6,1788,12,1659,11,1669,12,3329,24
Yemen,2009-06-18,2605,7,2589,4,5194,11,1875,10,1878,9,3754,20
Yemen,2009-06-19,1433,7,1431,6,2864,13,1808,8,1813,8,3621,17
Yemen,2009-06-20,2103,4,2074,4,4177,8,1819,7,1811,7,3631,14
Yemen,2009-06-21,2011,5,2015,6,4026,11,1831,6,1853,6,3684,13
Yemen,2009-06-22,1271,2,1310,4,2581,6,1805,5,1810,6,3616,11
Yemen,2009-06-23,2175,2,2225,5,4400,7,1784,4,1791,5,3575,9
Yemen,2009-06-24,1890,5,1958,2,3848,7,1926,4,1943,4,3870,9
Yemen,2009-06-25,1796,3,1777,3,3573,6,1811,4,1827,4,3638,8
Yemen,2009-06-26,1879,1,1927,3,3806,4,1875,3,1898,3,3773,7
Yemen,2009-06-27,2373,1,2467,4,4840,5,1913,2,1954,3,3867,6
Yemen,2009-06-28,2079,3,2100,2,4179,5,1923,2,1966,3,3889,5
Yemen,2009-06-29,1958,1,1974,2,3932,3,2021,2,2061,3,4082,5
Yemen,2009-06-30,0,3,0,2,0,5,1710,2,1743,2,3454,5
All Countries,2009-04-16,86808,0,86795,0,173603,0,86808,0,86795,0,173603,0
All Countries,2009-04-17,105738,0,106085,0,211823,0,96273,0,96440,0,192713,0
All Countries,2009-04-18,69799,1,69420,1,139219,2,87448,0,87433,0,174881,0
All Countries,2009-04-19,75621,11,76099,21,151720,32,84491,3,84599,5,169091,8
All Countries,2009-04-20,81163,37,81112,35,162275,72,83825,9,83902,11,167728,21
All Countries,2009-04-21,67090,62,66976,67,134066,129,81036,18,81081,20,162117,39
All Countries,2009-04-22,88329,72,88453,75,176782,147,82078,26,82134,28,164212,54
All Countries,2009-04-23,88883,75,88969,77,177852,152,82374,36,82444,39,164819,76
All Countries,2009-04-24,75213,76,74871,86,150084,162,78014,47,77985,51,155999,99
All Countries,2009-04-25,74414,65,74184,89,148598,154,78673,56,78666,64,157339,121
All Countries,2009-04-26,72605,75,72469,75,145074,150,78242,66,78147,72,156390,138
All Countries,2009-04-27,84456,77,84089,89,168545,166,78712,71,78573,79,157285,151
All Countries,2009-04-28,86021,86,86047,71,172068,157,81417,75,81297,80,162714,155
All Countries,2009-04-29,79076,87,77748,84,156824,171,80095,77,79768,81,159863,158
All Countries,2009-04-30,101558,119,100752,76,202310,195,81906,83,81451,81,163357,165
All Countries,2009-05-01,83765,100,84446,103,168211,203,83127,87,82819,83,165947,170
All Countries,2009-05-02,90225,156,90303,160,180528,316,85386,100,85122,94,170508,194
All Countries,2009-05-03,88680,226,89351,219,178031,445,87683,121,87533,114,175216,236
All Countries,2009-05-04,121297,448,121044,426,242341,874,92946,174,92813,162,185759,337
All Countries,2009-05-05,118400,799,118570,709,236970,1508,97571,276,97459,253,195030,530
All Countries,2009-05-06,97354,1292,98289,1308,195643,2600,100182,448,100393,428,200576,877
All Countries,2009-05-07,115310,1620,114708,1624,230018,3244,102147,663,102387,649,204534,1312
All Countries,2009-05-08,117764,1957,116884,1952,234648,3909,107004,928,107021,914,214025,1842
All Countries,2009-05-09,125598,2379,125910,2305,251508,4684,112057,1245,112108,1220,224165,2466
All Countries,2009-05-10,142817,2614,142863,2731,285680,5345,119791,1587,119752,1579,239544,3166
All Countries,2009-05-11,159481,3013,159067,2983,318548,5996,125246,1953,125184,1944,250430,3898
All Countries,2009-05-12,118722,3223,119293,3391,238015,6614,125292,2299,125287,2327,250580,4627
All Countries,2009-05-13,139262,3635,139135,3703,278397,7338,131279,2634,131122,2669,262402,5304
All Countries,2009-05-14,165106,4057,165482,4148,330588,8205,138392,2982,138376,3030,276769,6013
All Countries,2009-05-15,144081,4526,144022,4547,288103,9073,142152,3349,142253,3401,284405,6750
All Countries,2009-05-16,122028,5064,121059,5037,243087,10101,141642,3733,141560,3791,283202,7524
All Countries,2009-05-17,154076,5622,153922,5589,307998,11211,143250,4162,143140,4199,286390,8362
All Countries,2009-05-18,115241,6091,115063,6282,230304,12373,136930,4602,136853,4671,273784,9273
All Countries,2009-05-19,104543,6823,103507,6707,208050,13530,134905,5116,134598,5144,269503,10261
All Countries,2009-05-20,161396,7290,161377,7297,322773,14587,138067,5639,137776,5658,275843,11297
All Countries,2009-05-21,122679,7734,122442,7712,245121,15446,132006,6164,131627,6167,263633,12331
All Countries,2009-05-22,135474,8200,135818,8133,271292,16333,130776,6689,130455,6679,261232,13368
All Countries,2009-05-23,105210,8514,104391,8418,209601,16932,128374,7182,128074,7162,256448,14344
All Countries,2009-05-24,131021,8709,131323,8493,262344,17202,125080,7623,124845,7577,249926,15200
All Countries,2009-05-25,115042,8639,114698,8509,229740,17148,125052,7987,124793,7895,249845,15882
All Countries,2009-05-26,73581,8264,73635,8483,147216,16747,120629,8192,120526,8149,241155,16342
All Countries,2009-05-27,132245,8056,133057,7926,265302,15982,116464,8302,116480,8239,232945,16541
All Countries,2009-05-28,89409,7490,89484,7499,178893,14989,111711,8267,111772,8208,223484,16476
All Countries,2009-05-29,90360,6812,90208,7003,180568,13815,105266,8069,105256,8047,210523,16116
All Countries,2009-05-30,99540,6231,99352,6253,198892,12484,104456,7743,104536,7738,208993,15481
All Countries,2009-05-31,86790,5629,87415,5523,174205,11152,98138,7303,98264,7313,196402,14616
All Countries,2009-06-01,94856,4824,94647,4990,189503,9814,95254,6758,95399,6811,190654,13569
All Countries,2009-06-02,102027,4324,101569,4195,203596,8519,99318,6195,99390,6198,198708,12393
All Countries,2009-06-03,65932,3655,65726,3689,131658,7344,89844,5566,89771,5593,179616,11159
All Countries,2009-06-04,102242,3074,102901,3193,205143,6267,91678,4935,91688,4978,183366,9913
All Countries,2009-06-05,128607,2702,128359,2633,256966,5335,97142,4348,97138,4353,194280,8702
All Countries,2009-06-06,77707,2297,77896,2187,155603,4484,94023,3786,94073,3772,188096,7559
All Countries,2009-06-07,86866,1894,86957,1903,173823,3797,94033,3252,94007,3255,188041,6508
All Countries,2009-06-08,85277,1572,85195,1580,170472,3152,92665,2788,92657,2768,185323,5556
All Countries,2009-06-09,100443,1336,100977,1326,201420,2662,92439,2361,92573,2358,185012,4720
All Countries,2009-06-10,74322,1101,74196,1097,148518,2198,93637,1996,93783,1988,187420,3985
All Countries,2009-06-11,90848,937,91598,923,182446,1860,92010,1691,92168,1664,184178,3355
All Countries,2009-06-12,72583,752,72298,773,144881,1525,84006,1412,84159,1398,168166,2811
All Countries,2009-06-13,68105,659,68603,669,136708,1328,82634,1178,82832,1181,165466,2360
All Countries,2009-06-14,32226,526,31938,555,64164,1081,74829,983,74972,989,149801,1972
All Countries,2009-06-15,75309,462,76351,437,151660,899,73405,824,73708,825,147113,1650
All Countries,2009-06-16,88163,387,87873,394,176036,781,71650,689,71836,692,143487,1381
All Countries,2009-06-17,73414,303,74163,329,147577,632,71521,575,71832,582,143353,1158
All Countries,2009-06-18,84675,270,84729,269,169404,539,70639,479,70850,489,141490,969
All Countries,2009-06-19,52678,230,52487,220,105165,450,67795,405,68020,410,135816,815
All Countries,2009-06-20,54217,182,54172,209,108389,391,65811,337,65959,344,131770,681
All Countries,2009-06-21,104405,198,104442,158,208847,356,76123,290,76316,288,152439,578
All Countries,2009-06-22,76411,142,76570,169,152981,311,76280,244,76348,249,152628,494
All Countries,2009-06-23,76839,137,77632,141,154471,278,74662,208,74885,213,149547,422
All Countries,2009-06-24,96001,121,97067,133,193068,254,77889,182,78157,185,156046,368
All Countries,2009-06-25,88752,100,88082,122,176834,222,78471,158,78636,164,157107,323
All Countries,2009-06-26,60957,101,60652,102,121609,203,79654,140,79802,147,159457,287
All Countries,2009-06-27,95011,83,95168,91,190179,174,85482,126,85659,130,171141,256
All Countries,2009-06-28,82754,85,81840,95,164594,180,82389,109,82430,121,164819,231
All Countries,2009-06-29,77182,74,77593,93,154775,167,82499,100,82576,111,165075,211
All Countries,2009-06-30,0,94,0,97,0,191,71522,94,71486,104,143008,198
